D.......:~~:..:~~:..
....................
.:~~:.:~~:.....C....
.:~~:.....:~~:......
.:~~:.....:~~:......
.:~~:..:~~:.....:~~:
.:~~:......:~~:.....
.:~~:....GGG........
.:C~:....###........
.:~~:...............
....GGG.......GGG...
....###.......###...
....................
.~...1............X.
####################
